NO ./path_to_the_north_texture            
SO ./path_to_the_south_texture
WE ./path_to_the_west_texture
EA ./path_to_the_east_texture


C 225,30,0
F 200,200,0

        1111111111111111111111111
        1000000000110000111100001
        10110000011100001  100001
        100100000000000010 100001
1111111110110000011100001  100001
100000000011000001110111111111111
11110111111111011100000010001
11110111111111011101010010001
11000000110101011100000000001
10000000000000001100000010001
10000000000000000001010010001
11000001110101011111011110W0111
11110111 1110101 101111010001
11111111 1111111 111111111111
