NO ./path_to_the_north_texture
SO ./path_to_the_south_texture
WE ./path_to_the_west_texture
EA ./path_to_the_east_texture





C       30,144,255   
F 160,82,45

        111111111111111111111111
        1000000000110000000000001
        1011000001110000000000001
        1001000000000000000000001
111111111011000001110000000000001
100000000001100001110111111111111
11110111111111011100000010001
0111011111111101110101001000111
1100000011010101110000000001001
1000000000000000110000000000101
1000000000000000110101001001011
110000011010100111101111W0111
11110111 1110111 101111010001
111111111 1111 11 111111111111
