NO ./path_to_the_north_texture
SO ./path_to_the_south_texture
WE ./path_to_the_west_texture
EA ./path_to_the_east_texture


F 225,30,0
C 200,200,0

        1111111111111111111111111
        1000000000110000000000001
        1011000001110000111100001
        10010000000000001 0 10001
1111111110110000011100001  100001
100000000011000001110111111111111
11110111111111011100000010001
11110111111111011101010010001
110000001101010111000000000011111
100000000000000110000001000100001
100000000000000000010100100001111
11000001110101011111000110E01
11110111 1110101 101101010001
11111111 1111111 1111110111111111
