NO ./path_to_the_north_texture
SO ./path_to_the_south_texture
WE ./path_to_the_west_texture
EA ./path_to_the_east_texture


F 225,30,0
C 200,200,0

        1111111111111111111111111
        1000000000110000000000001
        10110000011100001111000011
        10010000000000001 0 100001
1111111110110000011100001  1000011
100000000011000001110111111111111
111101111111110111000000100011111
111101111111110111010100100011111
110000001101010111000000000010001
100000000000000110000001000101001
100000000000000000010100100010001
11000001110101011111000110N011101
11110111 1110101 1011010100010001
11111111 1111111 1111110111111111
