NO textures/BRICK_3B.PNG
SO textures/BRICK_3D.PNG
WE textures/BRICK_2B.PNG
EA textures/BRICK_1A.PNG





C 30,144,255  
F 160,82,45

 111111111111111
10000000000000001
10000000000000001
10000000000000001
10000000000000001
10000000000000001
100000000000000N1
10000000000000001
10000000000000001
 111111111111111