NO ./path_to_the_north_texture
SO ./path_to_the_south_texture
WE ./path_to_the_west_texture
EA ./path_to_the_east_texture





C       30,144,255   
F 160,82,45
11111111111111111
10000000000000001
10000000000000001
10000000000000001
10000000000000001
1000000N000000001
10000000000000001
10000000000000001
10000000000000001
11111111111111111