NO textures/BRICK_3B.PNG
SO textures/BRICK_3D.PNG
WE textures/BRICK_2B.PNG
EA textures/BRICK_1A.PNG




C       0,25,51
F       102,51,0

        1111111111111111111111111
        10000000001111110000000001
       10110000011110 10000000001
        10010000000011110000000011
111111111011000001110000000000001
10000000001100001110111111111101
1111011111111101110001 0100W1
0111011111111101110101011000111
1100000011010101110000000000111
100000000000000110000000000001
1000000000000000110101001001011
11000001101010011110111110111
11110111 1110111 101111010001
111111111 1111 11 11111110111