NO ./path_to_the_north_texture
SO ./path_to_the_south_texture
WE ./path_to_the_west_texture
EA ./path_to_the_east_texture





C       30,144,255   
F 160,82,45
111111111111111111111111111
100000000000000000000000001
100000000000000000000000001
100000000000000000000000001
100000000000000000000000001
1000000000000N0000000000001
100000000000000000000000001
100000000000000000000000001
100000000000000000000000001
111111111111111111111111111